***1*******************************
*** ****** ************************
***        ************************
************************   ********
********             ***** ********
******** ****** **** **          **
**       ****** **** ** ***********
** ************ **** ** ***********
** ************ **** *    *********
** ************ **** * ** *********
** ********            ** *********
** ******** ************* *********
**    ***** ************* *********
***** ***** ************* *********
***** ***** *********      ********
***** ***** ********* **** ********
***** ***** ********* **** ********
***** ***** ********* **** ********
*****                      ********
*************** *******************
***************0*******************
