306508400
520000000
087000031
003010080
900863005
050090600
130000250
000000074
005206300
